12 15 18 21
###################
#                 #
#  $   #   .      #
#  #      #       #
#  .     @  #     #
#  #   #     #    #
#     $   #       #
#  #   #     #    #
#  $   #  .  #    #
#  #   #     #  $ #
#     .   #       #
###################
