99
##################
#    #     #     #
#    #     #     #
# #  #  # @#  #  #
# #     #     #$ #
#.#     #     #  #
##################
