2 5 7
#########
#.      #
#  $ .  #
#       #
#$#.$   #
#  @  ###
#######
