3 10 15
####################
#         #  $     #
#  #   #     #     #
#      #  @  #  .  #
#  #   #     #     #
#     $   #   $    #
#  .  #     #     .#
#  #   #     #     #
#         #        #
####################
