99
#########
#    #  #
#    #$ #
# # @#  #
# #     #
#.#     #
#########
