13 45 23 78
###################
#  .   #       #  #
#  #      #   $   #
#  $  #  @  #     #
#  #   #     #    #
#     $   #   $   #
#  #   #     #   .#
#  $   #  .  #    #
#  #   #     #    #
#     .   #       #
###################
