50
####################
#                  #
# $                #
#################  #
#                  #
#                  #
# ##################
#                 @#
#                 .#
####################
