3 10
    ####
#####  #
#   $  #
# *.#  #
## ## ##
#      #
# @#   #
#  #####
####